1111111111111
1qwedfaslk001
100C011sdwq01
1P011E0000001
1111111111111