11111111111111111111
1P1000010C01001010C1
1010110101000C101001
1010010C001010101001
1001C11110101C000001
11000101000C11110101
10010101110100C10101
1111C000010100111101
10011110100C101010C1
1001000C100010010011
1000C1110011C10001C1
1011000001C000111001
10001C11100110000011
11100100001001110111
1C0100011010000000C1
110011100C1011111111
10100C0011001C010001
1CC1111100C1000101C1
1000000000000100C1E1
11111111111111111111
