1111111111111
100100001E0C1
1P00011111001
1000111110001
1111111111111